B,G,F,S
B1,G1,F1,S1
B2,G2,F2,S2
B3,G3,F3,S3
B4,G4,F4,S4
B5,G5,F5,S5
B6,G6,F6,S6
,,,S7
